
    C  225,30,0
    NO     text/north.xpm
   SO      text/south.xpm
  WE     text/west.xpm
  EA    text/east.xpm
   F  220,100,0
   
11111111111111111111111111
11000000000110000000000001
1011000001110000000000001111
100100000000000000000000111111111
111111111011000001110000000000001
10000000001100N001110111111111111
11110111111111011100000010001
11110111111111011101010010001
11000000110101011100000010001
10000000000000001100000010001
10000000000000001101010010001
1100000111010101111101111000111
1111011111101011011110100011
111111111111111111111111111




